Caves = done
Volcanos = done
Almonds:  latitude 0 to +-50 cultures: Palestinian = done
amber: cultures: alemannic, franks, pashtun, tasmanian, yagua, yoingu = done
ancient relics: // no info
apple: latitude +-20 to +-60 cultures: croatian, english, mittani, mocovi = done // common
banana: latitude 0 to +-30 cultures: caral supe, ghana, khmer, konjo, tairona = done // common
barley: cultures: akkadian, burgundian, xia, yemeni = done // common
bauxite ore: discovered in southern france = done # resource
beavers: latitude: +-50 to +-90 cultures: ainu, canadian, czech, flemish, kitaran, filippino, russian, Tungus = done // animal
Bison: latitude: 0 to +-65, cultures: helvetian, blackfoot, herero, polish, sioux, ukrainian = done // animal
camel: latitude 0 to +-65, cultures: arabian, kushan, kushite, lydian, numidian, tuareg, Uighur = done // animal
Clam: latitude: 0 to +-50, cultures: algerian, dahomey, tahitian, Toba, welsh = done // animal
coal: cultures: saudi = done # resource
coca: latitude 0 to +-30, cultures: chippewa, nazca, panaman = done
cocoa: latitude 0 to +-25, cultures: belgian, mixtec, wayana = done
coconut: latitude 0 to +-30, cultures: hawaiian, malaysian = done
coffe: latitude 0 to +-30, cultures: Cambeba, Colombian, Ethiopian = done
Copper ore: cultures: dacian, hyksosi, khitan, macedonian, poya, spartan, tiwi = done # resource
corn: latitudes +-20 to +-50, cultures: arawak, hopi, manchurian, missisipian = done // common
cotton: latitude 0 to +-30, cultures: confederates, Fulani, Mameluk, Turkmen = done
cow: latitude 0 to +-50, cultures: american, argentinian, hittite, masai, minoan, qing, senegali, tibetan, uruguayan, uzbek = done // animal
crab: latitude: +-30 to +-90, cultures: chimu, fijian, jomon, philistine, slovenian = done // animal
dates: latitude: 0 to +-50, cultures: zanzibari = done
deer: latitude: +-20 to +-90, cultures: bedouin, belizean, chavin, huron, nigerian, sami = done // animal
diamond: cultures: jute, Kanem-Bornu, Turkish = done # resource
donkey: cultures: breton, dzungar, romani = done // animal
elephants: latitude: 0 to +-30, cultures: dayak, ophir, pakistani, siamese, zulu = done // animal
fig: latitude: 0 to 45, cultures: abbasid, adenan, sicilian, wallachian = done
fine clay: cultures: chumash, kipchak, hungarian, joseon, latvian, noongar, tlatilco, valdivian = done // no production info
fish: cultures: Furawi, japanese, nootka, pilaga, polynesian, portugese, swahili, swedish = done // animal
flax: cultures: batavian, mohawk, tang, tatar = done
fossil beds: = done
geode: = done # resource
geothermal energy: = done
gold ore: cultures: angolan, aragonese, australian, californian, danish, mutapa, nok, persian, spanish, thracian, three kingdoms, xiongnu, zapotec = done # resource
grapes: latitude: +-20 to +-50, cultures: armenian, catalonian, french, galatian, klamath, longobardian, quebecker, vietnamese = done
guavas: latitude: 0 to +-25 = done
guinea pigs: latitude: 0 to +-45 // animal
hemp: cultures: dutch, guatemalan, jamaican, jivaro, mandan, nepalese, somali = done // no production info
henna: latitude: 0 to +-30, cultures: bashkir, sabbatean // no production info
horse: latitude: +-30 to +-90, cultures: assyrian, cheyenne, comanche, ecuadorian, gaucho, hun, mongolian, roxolani = done // animal
hytrothermal vent: = done
incense: cultures: himayarite, holy roman, huastec, sican, xianbei = done // no production info
indigo, latitude: 0 to +-60, cultures: aksumite, guyanese, hausa, ilocano, mayan, venetian = done // no production info
iron ore: cultures: byzantine, gokturk, killke, mexican, norman, saxon, songhai = done # resource
jade: cultures: lianghzu, median, olmec, shang = done # resource
kangaroo: latitude: -70 to +10, cultures: aborigine = done
kava: latitude: -30 to +10, cultures: chamorran = done
lead ore: cultures: athenian, bulgarian, epirus, illyrian, qin, swazi, trojan = done # resource
lemons: latitude: 0 to +-30 = done
llama: cultures: kogi, quechua, yanomami = done
lobster:  cultures: nebateans = done // animal
mammoths: latitude: +-50 to +-90, cultures: siberian = done // animal
manganese: = done # resource
mango: latitude: 0 to +-30, cultures: papuan = done
marble: cultures: azande, georgian, greek, ming, mughal, peruvian = done // no production info
melons: latitude: 0 to +-40, cultures: kazakh = done
methane ice: = done
murex: latitude: 0 to +-23, cultures: andamanese, avernian, carthaginian, phoenician, tunisian = done // animal
mushrooms: cultures: carib, goth, kurdish, muisca, pictish, qiang = done // no production info
natron: = done
natural gas: cultures: jordanian, soviet = done
obsidian: cultures: aztec, melanesian, saka // no production info # resource
oil: cultures: norwegian, texan, venezuelan = done
olives: latitude: +-20 to +-50, cultures: iraqi, khazar, roman, syrian, tajik = done
opium: latitude: +-20 to +-50, cultures: fatimid, sudanese = done
papaya: latitude: 0 to +-25, cultures: guarani, tagalog, taiwanese = done
papyrus: latitude: 0 to +-60, cultures: nubian = done // no production info
parrots: latitude: 0 to +-45, cultures: amis, omani, tupi = done // animal
pearls: cultures: dravidian, indonesian, quolla, samoan, tongan, yaghan = done // animal
peyote: cultures: apache, capayan, paiute = done // no production info
pig: latitude: 0 to +-50, cultures: bavarian, german, indus, korean, semang, tanzanian = done // animal
pistachio: latitude: 0 to +-50, cultures: canari, paraguayan = done
platinum ore: cultures: prussian = done # resource
pomegranate: latitude: 0 to +-50, cultures: safavid = done
potatoes: latitude: +-30 to +-60, cultures: incan, irish, zuni = done // common
poultry: cultures: briton, cantonese, hopewell, kenyan, lusitanian, nahua, slovakian, wari = done // animal
prickly pear: cultures: mollo, surinamese = done // no production info
prime timber: cultures: burmese, Celtiberian, hurrians, iroquois, kongolese, lebanese, maori, orang asli, sintashta, viking = done
pumpkin: latitude 0 to +-40, cultures: cherokee, red ocher, Tucano = done
rabbit: cultures: austrian, avaric, cree, maric = done // animal
resin: cultures: chechen, lithuanian, tlaxcaltec = done // no production info
rice: latitude: 0 to +-50, cultures: hemudu, merina, thai = done
rubber: latitude: 0 to +-20 = done
rubies: culture: ghurid, libyan = done # resource
salt: cultures: bangladeshi, israeli, malinese, transoxanian = done # resource
sapphires: cultures: bahraini, luba = done # resource
sea lion and seal: cultures: dene, fuegian, scotish, south african, vanuatuan = done // animal
sheep: latitude: +-20 to +-90, cultures: afghan, albanian, berber, celtic, navajo, new zealander. serbian, sumerian = done // animal
shrimp: cultures: estonian, seminole, sundanese, yamato = done // animal
silk: cultures: chinese, khwarazmian, sassanian = done
silver ore: cultures: bactric, bolivian, la platan, malagasy, nama, saffarid, scythian, swiss, timurid, wayuu = done # resource
spices: cultures: indian, aymara, bandanese, basque, batek, etruscan, mani, moroccan = done
squash: latitude: 0 to +-40 cultures: zenu = done
stone: cultures: egyptian, guanches, micronesian, poverty point, rapa nui, sarmatian, tamil, toltec = done // no production info / common
sugar: latitude: 0 to +-36, cultures: brazilian, cham, haitian, javanese = done
sulphur: cultures: ashanti, bengali, iranian, ottoman, pima = done # resource
tea: latitude: +-20 to +-60, cultures: alacalufe, ceylonese, hongkonger, lunda, seljuk = done
tin ore: cultures: chola, parthian, tarascan = done # resource
titanium ore: = done # resource
tobacco: latitude: +-15 to +-60, cultures: chilean, cuban, lule, odawa, rhodesian, waray = done
turquoise: latitude: 0 to +-40, cultures: anasazi, kuwaiti, massagetae, moche, vandal = done # resource
uranium: = done
vanilia: latitude: 0 to +-30, cultures: chachapoya, totonac = done
walrus: latitude: +-65 to +-90, cultures: finnish, inuit, querendi = done // animal
whale: cultures: icelandic, puelche, puntic, zimbabwean = done // animal
wheat: latitude +-10 to +-50, cultures: babylonian, benin, italian, mapuche, sennar = done // common
-- reduction of all bonuses, random assignment for "//", mountain resources
!Extras:
Brazil Nut: almonds + coffee = done
Cashew: almonds + corn = done
chestnut: almonds + tea = done
cinnamomum: almonds + spices = done
Gevuina: almonds + Guavas = done
Hazelnut: almonds + cocoa = done
macadamia: almonds + olives = done
mongongo: almonds + melons = done
morel mushrooms: almonds + mushrooms = done
peanut: almonds + potatoes = done
pecan: almonds + tobacco = done
pine nut: almonds + prime timber = done
walnut: almonds + lemons = done
cicada gatherer: almonds + silk = done
citrine: amber + sulphur = done
topaz: amber + gold ore = done
unesco heritage site: ancient relics = done
rosetta stone: ancient relics = done
apricot: apple + olives = done
atemoya: apple + papaya = done
bolete: apple + mushrooms = done
breadfruit: apple + wheat = done
cherry: apple + prime timber = done
ducks: apple + poultry = done
loquat: apple + mango = done
orange: apple + lemons = done
peach: apple + rice = done
pear: apple + tea = done
pitaya: apple + tobacco = done
plum: apple + sugar = done
rose: apple + flax = done?
strawberry: apple + grapes = done
tomatillo: apple + corn = done
tomato: apple + potatoes = done
durian: banana + coffee = done
hibiscus: banana + flax = done
jungleflowl: banana + parrots = done
kiwifruit: banana + cotton = done
monkey breeder: banana = done?
persimmon: banana + rice = done
pineapple: banana + sugar = done
plantain: banana + olives = done
snow fungus: banana + mushrooms = done
starfruit: banana + guavas = done
tangerine: banana + lemons = done
taro: bananas + potatoes = done
foxglove: barley + flax = done?
gerbil breeder: barley + guinea pigs = done
grasshopper gatherer: barley + silk = done?
parakeet: barley + parrots = done
rye: barley + wheat = done
sassafras: barley + spices = done
berlinite: bauxite + diamond = done
caesium: bauxite + silver = done
chromite: bauxite + iron = done
lazulite: bauxite + sapphires = done
nickel: bauxite + sulphur = done
breeding program fox: beavers = done?
hippo (trap/bp): bison + elephants = done
cod: clam + fish = done?
conch: clam + murex = done?
giant clam: clam + whales = done
sea turtle egg: clam + sea lion and seal = ???
squid: clam + pearls = ???
graphite: coal + stone = done
shale plant: coal + stone = done???
jet: coal + obsidian
mascagnite: coal + sulphur
quetzal: cocoa + parrots
scorpion gatherer: cocoa + silk
birds-of-paradise: coconut + parrots
cassava: coconut + potatoes
longan: coconut + mango
blueberry: coffe + grapes
giant cockroach gatherer: coffe + silk
macaw: coffee + parrots
turnip: coffee + potatoes
Po ngbe: olmec + copper | iron
zinc: copper + silver
artichoke: corn + olives
avocado: corn + lemons
bell pepper: corn + potatoes
raccoon: corn + beavers
cherimoya: corn + papaya
chili: corn + spices
corn smut: corn + mushrooms
eggplant: corn + rice
hamster breeder: corn + guinea pigs
jumiles gatherer: corn + silk
papaya: corn + mango
quinoa: corn + wheat
trap(racoon): corn + beavers
sunflower: corn + flax
turkey: corn + poultry
zucchini: corn + squash
cauliflower: cotton + potatoes
cauliflower mushroom: cotton + mushrooms
daisy: cotton + flax
weaving spider gatherer: cotton + silk
oxen farm: cow
yak farm: cow + peak
jujube: dates + mango
palm weeveil gatherer: dates + silk
antelope (trap/bp): deer + horse
caribu (trap/bp): deer + taiga/tundra/ice + latitude < 40
giraffe (trap/bp): deer + elephants
moose(trap/bp): deer
fly agaric gatherer: deer + mushrooms
quartz: diamond + stone
ostrich (trap/bp): elephants + poultry
rhino (trap/bp): elephants + pigs
zebra (trap/bp): elephants + horse
dung beetle gatherer: elephants + silk
ming vase workshop: fine clay
nok sculpture workshop: fine clay
red and black ware painter: fine clay
terra sigillata workshop: fine clay
potash: fine clay + salt
anchovy: fish + pearls
cormorant trainer: fish + poultry
dragonfly gatherer: fish + silk
flounder: fish + murex
sardine: fish + shrimp
sea bass: fish + sea lion and seal
shark: fish + whale
shiitake mushroom: fish + mushrooms
snapper: fish + lobser
begonia: flax + sugar
bluebell+ flax + tobacco
butterfly gatherer: flax + silk
carnation: flax + lemons
coral tooth mushroom: flax + mushroom
hummingbird: flax + parrots
iris: flax + potatoes
lily: flax + rice
orchid: flax + tea
pansy: flax + spices
snapdragon: flax + incense
tulip: flax + wheat
violet: flax + hemp
ammonite fossil: fb + clam
archaeopteryx fossil: fb + pultry
dimetrodon fossil: fb + pigs
ichthyostega fossil: fb + coal
mamooth fossil: fb + mammoths
neanderthal fossil: fb + stone
petrified wood: fb + prime timber
plesiosaur fossils: fb + whale
pterodactyl fossil: fb + oil
shark teeth: fb + fish
smilodon fossil; fb + wheat
triceratops fossil: fb + cow
trilobite fossil: fb + crab
velocilaptor fossil: fb + horse
bearberry: grapes + tea
belladona: grapes
blackberry: grapes + tobacco
blueberry: grapes + coffee
Cranaberry: grapes + rice
Elderberry: grapes + hemp
Falconer: grapes + poultry
goosberry: grapes + olives
grapefruit: grapes + lemons
lyches: grapes + mango
peppermint: grapes + spices
portobello mushroom: grapes + mushrooms
raspberry: grapes + sugar
vineyard: grapes
mouse breeder: guinea pigs + wheat
rat breeder: guinea pigs + rice
cola: hemp + prime timber
cannabis: hemp
spinach: hemp + potatoes
marsh Mallow: hemp + sugar
frankincense: incense
myrrh: incense + tea
saffron: incense + spices
scarb beetle: incense + silk
brazilwood: indigo + prime timber
cochineal: indigo + prickly pear
death cap mushroom: indigo
fustic: indigo + papaya
junebug gatherer: indigo + silk
madder: indigo + tea
amethyst: iron ore + sapphires
magnesium: iron ore + salt
magnetite: iron ore + obsidian
manganese: iron ore + lead ore
pyrite: iron ore + sulphur
tungsten: iron ore + tin ore
jade death mask carver: jade
liangzhu,olmec,shang jade jade carvers: jade
emerald: jade + lead ore
onyx: jade + marble
emu: kangaroo + poultry
diprotodon: kangaroo + mammoths
lithium: lead ore + salt
cinnabar: lead ore + silver ore
chanterelle gatherer: lemons + mushrooms
kumquat: lemons + mango
lime: lemons + spices
onion: lemons + potatoes
radish+ lemon + wheat
alpaca: llama
rhe: llama + poultry
megatherium: llama + mammoth
centipide gatherer: lobster + silk
prawn: lobster + shrimp
wooly rhino: mamooth + pigs
allspices: mango + spices
jujube: mango + dates
sapote: mango + papaya
tarantula gatherer: mango + silk
toucan: mango + poultry
cheomseongdae: marble | stone
The great pyramid: marble | stone
the great sphinx: marble | stone
hierapolis sawmill: marble | stone
the parthenon: marble
taj mahal: marble
canteloupe: melons + pumpkin
calabash: melons + squash
goliath beetle: melons + silk
honeydew: melons + sugar
licorice: melons + spices
abalone diggers: murex + pearls
trufle: mushrooms + obsidian
enokitake: mushrooms + spices
hedgehog mushroom: mushrooms + bison
oyster mushrooms: mushrooms + pearls
straw mushroom: mushroom + rice
pine mushroom: mushrooms + prime timber
shaggy parasol mushroom: mushrooms + squash
shimeji mushroom: mushroom + silk
white truffle gatherer: mushrooms + pigs
golden spike: oil | coal
route 66: oil
broccoli: olives + potatoes
goose: olives + poultry
lettuce: olives + rice
oat: olives + wheat
black pepper: olives + spices
hercules beattle: papaya + silk
nutmeg + papaya + spices
assasin bug: parrots + silk
canary: parrots + wheat
cockatoo: parrots + pistachio
peacock: parrots + spices
parrotfish: pearls + whale
cardon cactus: peyote + prickly pear
mezcal worm: peyote + silk
praying mantis: peyote + tea
boar: pigs
firefly gatherer: pistachio + silk
cabbage: potatoes + tea
carrot: potatoes + wheat
cucumber: potatoes + squash
garlic: potatoes + spices
kale: potatoes + tobacco
leek: potatoes + rice
sweet potatoes: potatoes + sugar
pigeon: poultry + stone
agave+ prickly pear + sugar
ark of covenant: prime timber
confuncian school: prime timber
quanzhen school: prime timber
oak: prime timber + wheat
cloves: prime timber + spices
curare: prime timber
maple: prime timber + sugar
chinchilla: rabbit + beavers
acacia: resin + spices
mopane moth: resin + silk
celery: rice + sugar
ginger root: rice + spices
soybean: rice + wheat
wasabi: rice + tea
garnet: rubies + salt
borax: salt + stone
fluorite: sapphires + stone
beluga: sea lion and seal + whale
elephant seal: sea lion and seal + walrus
sea otter: sea lion and seal + beavers
mink: sheep + beavers
mouflon: sheep
muskox: sheep + bison
goat: sheep
marlin: shrimp + whale
pillbug: shrimp + silk
cricket gatherer: silk + spices
mealworm gatherer: silk + wheat
chives: spices + tobacco
ginkgo: spices + tea
rhubarb: spices + sugar
sesame: spices + wheat
via appia: stone
behistun inscription: stone
el escoral: stone
six harmonies pagoda: stone
gate of the sun: stone
gobekil tepe: stone
krak des chevaliers: stone
ha'amonga'a Maui: stone
moai status: stone
muiderslot castle: stone
stonehenge: stone
fine stoneware carvers: stone
chalk: stone
cobalt: stone + sulphur
lizards: stone
sorghum: sugar + wheat
millet: tea + wheat
narwhal: walrus + whale
-- final reduction, balancing
file.write(f"\tVersion=C2C_2\n")
        file.write(f"\tDescription=Custom Earth Map\n")
        file.write(f"\tModPath=Mods\\Caveman2Cosmos\n")
        file.write(f"EndMeta\n")
        file.write(f"BeginGame\n")
        file.write(f"\tEra=C2C_ERA_PREHISTORIC\n")
        file.write(f"\tSpeed=GAMESPEED_ETERNITY\n")
        file.write(f"\tCalendar=CALENDAR_DEFAULT\n")
        file.write(f"\tOption=GAMEOPTION_BARBARIAN_CIV\n")
        file.write(f"\tOption=GAMEOPTION_BARBARIAN_NEANDERTHAL_CITIES\n")
        file.write(f"\tOption=GAMEOPTION_LEADER_DEVELOPING\n")
        file.write(f"\tOption=GAMEOPTION_LEADER_START_NO_POSITIVE_TRAITS\n")
        file.write(f"\tOption=GAMEOPTION_LEADER_COMPLEX_TRAITS\n")
        file.write(f"\tOption=GAMEOPTION_ENABLE_UNITED_NATIONS\n")
        file.write(f"\tOption=GAMEOPTION_NO_TECH_BROKERING\n")
        file.write(f"\tOption=GAMEOPTION_TECH_DIFFUSION\n")
        file.write(f"\tOption=GAMEOPTION_TECH_WIN_FOR_LOSING\n")
        file.write(f"\tOption=GAMEOPTION_TECH_UPSCALED_COSTS\n")
        file.write(f"\tOption=GAMEOPTION_TECH_BEELINE_STINGS\n")
        file.write(f"\tOption=GAMEOPTION_CULTURE_FLIPPING_AFTER_CONQUEST\n")
        file.write(f"\tOption=GAMEOPTION_CULTURE_REALISTIC_SPREAD\n")
        file.write(f"\tOption=GAMEOPTION_CULTURE_EQUILIBRIUM\n")
        file.write(f"\tOption=GAMEOPTION_CULTURE_1_CITY_TILE_FOUNDING\n")
        file.write(f"\tOption=GAMEOPTION_RELIGION_DIVINE_PROPHETS\n")
        file.write(f"\tOption=GAMEOPTION_RELIGION_DISABLING\n")
        file.write(f"\tOption=GAMEOPTION_RELIGION_INQUISITIONS\n")
        file.write(f"\tOption=GAMEOPTION_EXP_STRICT_VICINITY\n")
        file.write(f"\tOption=GAMEOPTION_ANIMAL_DANGEROUS\n")
        file.write(f"\tOption=GAMEOPTION_COMBAT_SIZE_MATTERS\n")
        file.write(f"\tOption=GAMEOPTION_COMBAT_SURROUND_DESTROY\n")
        file.write(f"\tOption=GAMEOPTION_COMBAT_HIDE_SEEK\n")
        file.write(f"\tOption=GAMEOPTION_COMBAT_WITHOUT_WARNING\n")
        file.write(f"\tOption=GAMEOPTION_COMBAT_FIGHT_OR_FLIGHT\n")
        file.write(f"\tOption=GAMEOPTION_COMBAT_REALISTIC_SIEGE\n")
        file.write(f"\tOption=GAMEOPTION_UNIT_GREAT_COMMANDERS\n")
        file.write(f"\tOption=GAMEOPTION_UNIT_XP_FROM_SPECIALISTS\n")
        file.write(f"\tOption=GAMEOPTION_UNIT_INFINITE_XP\n")
        file.write(f"\tOption=GAMEOPTION_UNIT_DOWNSIZING_IS_PROFITABLE\n")
        file.write(f"\tOption=GAMEOPTION_ADVANCED_DIPLOMACY\n")
        file.write(f"\tOption=GAMEOPTION_ADVANCED_ESPIONAGE\n")
        file.write(f"\tOption=GAMEOPTION_ADVANCED_NUKES\n")
        file.write(f"\tOption=GAMEOPTION_ADVANCED_ROUTES\n")
        file.write(f"\tOption=GAMEOPTION_ADVANCED_REALISTIC_CORPORATIONS\n")
        file.write(f"\tVictory=VICTORY_CONQUEST\n")
        file.write(f"\tGameTurn=0\n")
        file.write(f"\tMaxTurns=0\n")
        file.write(f"\tMaxCityElimination=0\n")
        file.write(f"\tNumAdvancedStartPoints=0\n")
        file.write(f"\tTargetScore=0\n")
        file.write(f"\tStartYear=-200000\n")
        file.write(f"EndGame\n")
        file.write(f"BeginMap\n")
        file.write(f"\tgrid width={size[0]}\n")
        file.write(f"\tgrid height={size[1]}\n")
        file.write(f"\ttop latitude=80\n")
        file.write(f"\tbottom latitude=-70\n")
        file.write(f"\twrap X=1\n")
        file.write(f"\tworld size=WORLDSIZE_GIGANTIC\n")
        file.write(f"\tclimate=CLIMATE_TEMPERATE\n")
        file.write(f"\tsealevel=SEALEVEL_MEDIUM\n")
        file.write(f"\tRandomize Resources=0\n")
        file.write(f"EndMap\n")
        file.write(f"BeginPlayer\n")
        file.write(f"CivType=CIVILIZATION_AMERICA\n")
        file.write(f"LeaderType=LEADER_LINCOLN\n")
        file.write(f"StartingX=92, StartingY=98\n")
        file.write(f"EndPlayer\n")
        file.write(f"BeginPlayer\n")
        file.write(f"CivType=CIVILIZATION_ARABIA\n")
        file.write(f"LeaderType=LEADER_SALADIN\n")
        file.write(f"StartingX=189, StartingY=82\n")
        file.write(f"EndPlayer\n")
        file.write(f"BeginPlayer\n")
        file.write(f"CivType=CIVILIZATION_AZTEC\n")
        file.write(f"LeaderType=LEADER_MONTEZUMA\n")
        file.write(f"StartingX=71, StartingY=78\n")
        file.write(f"EndPlayer\n")
        file.write(f"BeginPlayer\n")
        file.write(f"CivType=CIVILIZATION_CARTHAGE\n")
        file.write(f"LeaderType=LEADER_HANNIBAL\n")
        file.write(f"StartingX=159, StartingY=95\n")
        file.write(f"EndPlayer\n")
        file.write(f"BeginPlayer\n")
        file.write(f"CivType=CIVILIZATION_CHINA\n")
        file.write(f"LeaderType=LEADER_QIN_SHI_HUANG\n")
        file.write(f"StartingX=268, StartingY=99\n")
        file.write(f"EndPlayer\n")
        file.write(f"BeginPlayer\n")
        file.write(f"CivType=CIVILIZATION_EGYPT\n")
        file.write(f"LeaderType=LEADER_CLEOPATRA\n")
        file.write(f"StartingX=183, StartingY=82\n")
        file.write(f"EndPlayer\n")
        file.write(f"BeginPlayer\n")
        file.write(f"CivType=CIVILIZATION_ENGLAND\n")
        file.write(f"LeaderType=LEADER_VICTORIA\n")
        file.write(f"StartingX=149, StartingY=111\n")
        file.write(f"EndPlayer\n")
        file.write(f"BeginPlayer\n")
        file.write(f"CivType=CIVILIZATION_ETHIOPIA\n")
        file.write(f"LeaderType=LEADER_MENELIK\n")
        file.write(f"StartingX=189, StartingY=73\n")
        file.write(f"EndPlayer\n")
        file.write(f"BeginPlayer\n")
        file.write(f"CivType=CIVILIZATION_FRANCE\n")
        file.write(f"LeaderType=LEADER_NAPOLEON\n")
        file.write(f"StartingX=151, StartingY=107\n")
        file.write(f"EndPlayer\n")
        file.write(f"BeginPlayer\n")
        file.write(f"CivType=CIVILIZATION_GERMANY\n")
        file.write(f"LeaderType=LEADER_BISMARCK\n")
        file.write(f"StartingX=163, StartingY=111\n")
        file.write(f"EndPlayer\n")
        file.write(f"EndPlayer\n")
        file.write(f"BeginPlayer\n")
        file.write(f"CivType=CIVILIZATION_GREECE\n")
        file.write(f"LeaderType=LEADER_ALEXANDER\n")
        file.write(f"StartingX=174, StartingY=99\n")
        file.write(f"EndPlayer\n")
        file.write(f"BeginPlayer\n")
        file.write(f"CivType=CIVILIZATION_INCA\n")
        file.write(f"LeaderType=LEADER_PACHACUTI\n")
        file.write(f"StartingX=97, StartingY=47\n")
        file.write(f"EndPlayer\n")
        file.write(f"BeginPlayer\n")
        file.write(f"CivType=CIVILIZATION_INDIA\n")
        file.write(f"LeaderType=LEADER_GANDHI\n")
        file.write(f"StartingX=226, StartingY=89\n")
        file.write(f"EndPlayer\n")
        file.write(f"BeginPlayer\n")
        file.write(f"CivType=CIVILIZATION_JAPAN\n")
        file.write(f"LeaderType=LEADER_TOKUGAWA\n")
        file.write(f"StartingX=285, StartingY=94\n")
        file.write(f"EndPlayer\n")
        file.write(f"BeginPlayer\n")
        file.write(f"CivType=CIVILIZATION_KOREA\n")
        file.write(f"LeaderType=LEADER_SEJONG\n")
        file.write(f"StartingX=276, StartingY=97\n")
        file.write(f"EndPlayer\n")
        file.write(f"BeginPlayer\n")
        file.write(f"CivType=CIVILIZATION_MALI\n")
        file.write(f"LeaderType=LEADER_MANSA_MUSA\n")
        file.write(f"StartingX=141, StartingY=72\n")
        file.write(f"EndPlayer\n")
        file.write(f"BeginPlayer\n")
        file.write(f"CivType=CIVILIZATION_MAYA\n")
        file.write(f"LeaderType=LEADER_PACAL\n")
        file.write(f"StartingX=80, StartingY=77\n")
        file.write(f"EndPlayer\n")
        file.write(f"BeginPlayer\n")
        file.write(f"ivType=CIVILIZATION_MONGOL\n")
        file.write(f"LeaderType=LEADER_GENGHIS_KHAN\n")
        file.write(f"StartingX=255, StartingY=106\n")
        file.write(f"EndPlayer\n")
        file.write(f"BeginPlayer\n")
        file.write(f"CivType=CIVILIZATION_OTTOMAN\n")
        file.write(f"LeaderType=LEADER_SULEIMAN\n")
        file.write(f"StartingX=179, StartingY=100\n")
        file.write(f"EndPlayer\n")
        file.write(f"BeginPlayer\n")
        file.write(f"CivType=CIVILIZATION_PERSIA\n")
        file.write(f"LeaderType=LEADER_CYRUS\n")
        file.write(f"StartingX=203, StartingY=89\n")
        file.write(f"EndPlayer\n")
        file.write(f"BeginPlayer\n")
        file.write(f"CivType=CIVILIZATION_ROME\n")
        file.write(f"LeaderType=LEADER_JULIUS_CAESAR\n")
        file.write(f"StartingX=162, StartingY=101\n")
        file.write(f"EndPlayer\n")
        file.write(f"BeginPlayer\n")
        file.write(f"ivType=CIVILIZATION_RUSSIA\n")
        file.write(f"LeaderType=LEADER_CATHERINE\n")
        file.write(f"StartingX=186, StartingY=114\n")
        file.write(f"EndPlayer\n")
        file.write(f"BeginPlayer\n")
        file.write(f"CivType=CIVILIZATION_SPAIN\n")
        file.write(f"LeaderType=LEADER_ISABELLA\n")
        file.write(f"StartingX=145, StartingY=99\n")
        file.write(f"EndPlayer\n")
        file.write(f"BeginPlayer\n")
        file.write(f"CivType=CIVILIZATION_SCANDINAVIA\n")
        file.write(f"LeaderType=LEADER_RAGNAR\n")
        file.write(f"StartingX=167, StartingY=120\n")
        file.write(f"EndPlayer\n")
        file.write(f"BeginPlayer\n")
        file.write(f"CivType=CIVILIZATION_ZULU\n")
        file.write(f"LeaderType=LEADER_SHAKA\n")
        file.write(f"StartingX=178, StartingY=39\n")
        file.write(f"EndPlayer\n")
        file.write(f"BeginPlayer\n")
        file.write(f"CivType=CIVILIZATION_AUSTRALIA\n")
        file.write(f"LeaderType=LEADER_CURTIN\n")
        file.write(f"StartingX=288, StartingY=25\n")
        file.write(f"EndPlayer\n")
        file.write(f"BeginPlayer\n")
        file.write(f"CivType=CIVILIZATION_ABORIGINES\n")
        file.write(f"LeaderType=LEADER_YAGAN\n")
        file.write(f"StartingX=269, StartingY=36\n")
        file.write(f"EndPlayer\n")
        file.write(f"BeginPlayer\n")
        file.write(f"CivType=CIVILIZATION_BRAZIL\n")
        file.write(f"LeaderType=LEADER_PEDRO_II\n")
        file.write(f"StartingX=123, StartingY=46\n")
        file.write(f"EndPlayer\n")
        file.write(f"BeginPlayer\n")
        file.write(f"CivType=CIVILIZATION_ISRAEL\n")
        file.write(f"LeaderType=LEADER_DAVID\n")
        file.write(f"StartingX=185, StartingY=92\n")
        file.write(f"EndPlayer\n")
        file.write(f"BeginPlayer\n")
        file.write(f"CivType=CIVILIZATION_SUMERIA\n")
        file.write(f"LeaderType=LEADER_GILGAMESH\n")
        file.write(f"StartingX=196, StartingY=90\n")
        file.write(f"EndPlayer\n")
        file.write(f"BeginPlayer\n")
        file.write(f"CivType=CIVILIZATION_SIAM\n")
        file.write(f"LeaderType=LEADER_MONGKUT\n")
        file.write(f"StartingX=251, StartingY=73\n")
        file.write(f"EndPlayer\n")
        file.write(f"BeginPlayer\n")
        file.write(f"CivType=CIVILIZATION_IROQUOIS\n")
        file.write(f"LeaderType=LEADER_DEGANAWIDA\n")
        file.write(f"StartingX=95, StartingY=103\n")
        file.write(f"EndPlayer\n")